1111111111
1111111111
2200000022
2200000022
2222002222
2222002222
0000220000
0000220000
0022222200
0022222200
1111111111
1111111111
1111111111
1111111111
0022111100
0022111100