*UI\\Map illust\\Forth map original.bmp
~UI\\\\Reload\\\endingCredit.bmp
w w D D D D w w 
w w gegegegew w 
w w p p p p w w 
w w p p p p w w 
w p p p p p p w 
w p p p p p p w 
p p p s p p p p 
p p p s p p p p 
p p p p p p p p 
p p p p p p p p 
p p p p p p p p 
p p p p p p p p 
p p p p p p p p 
p p p p p p p p 
D D D D D D D D 
bebebebebebebebe
